##########################################
#                                        #
#  #################      ################
#                  #      #              #
#####################    ############    #
#                 #                      #
#           #             ################
######################                   #
#                    #                   #
#        #           #       ########### #
#  ##################   @                #
#                                        #
##########################################