##########################################
#                ##                      #
#     #          #     # #################
#######   ########   # #                 #
#         #          # ###############   #
#         #  ######  # #                 #
#         #          # #                 #
# ######### ########## #######           #
# #         #        @       #  ##########
# #      #  ##################  #        #
# ########  #               #   ### ###  #
#                  ##########       #    #
##########################################
